11111111111111111111111111111111111111111111111111111111111111111111
10000011111100000000000000000000000111111000000000000000000000000001
10P00011111100000000000000C00000000111111000000000000000000000000001
10000011111100000000000000000000000111111000000000000000000000000001
100000111111000000000000000000000001111110000000000000C0000000000001
10000011111100000000000000000000000111111000000000000000000000000001
1000000000000000000000C000000000000111111000000000000000000000000001
10000000000000000000000000000000000111111000000000000000000000000001
10000000C00000000000000000000000000111111000000000000000000000000001
10000000000000000000000000000000000111111000000000000000000000000001
10000000000000000000000000000000000000000000000000011111100000000001
10000000000000000000000000000000000000000000000000011111100000000001
1000000000000000000C000000000000000000000000000000011111100000000001
1000000000000000000001111110000000000000000C000000011111100000000001
10000000000000000000011111100000000000000000000000011111100000000001
10000000000000000000011111100C00000000000000000000011111100000000001
10000000000000000000011111100000000000000000000000011111100000000001
1000000C00000000000001111110000E000000000000000000000000000000000001
10000000000000000000011111100000000000000000000000000000000000000001
11111111111111111111111111111111111111111111111111111111111111111111