111111111111111111111111111111111111111111111111111111111111
100000111111000000000000000000000001111110000000000000000001
10000011111100000000000000C000000001111110000000000000000001
100000111111000000000000000000000001111110000000000000000001
100000111111000000000000000000000001111110000000000000C00001
100000111111000000000000000000000001111110000000000000000001
1000000000000000000000C0000000000001111110000000000000000001
100000000000000000000000000000000001111110000000000000000001
10000000C000000000000000000000000001111110000000000000000001
100000000000000000000000000000000001111110000000000000000001
100000000000000000000000000000000000000000000000000111111001
100000000000000000000000000000000000000000000000000111111001
10000P0000000000000C0000000000000000000000000000000111111001
1000000000000000000001111110000000000000000C0000000111111001
100000000000000000000111111000000000000000000000000111111001
10000000000000000000011111100C000000000000000000000111111001
100000000000000000000111111000000000000000000000000111111001
1000000C0000000000000111111000000000000000000000000000000001
1000000000000000000001111110000000000000000000000000000000E1
111111111111111111111111111111111111111111111111111111111111